#######################################################
#                                                     #
#                                                     #
#                   ###############                   #
#                   #             #                   #
#                   #             #                   #
#                   #             #                   # 
#   #############   #   #######   #   #############   #
#   #           #   #   #     #   #   #           #   #
#   #           #   #   #     #   #   #           #   #
#   #############   #   #     #   #   #############   #
#                   #             #                   #
#                   #             #                   #
#                   #             #                   #
##############      ######   ######       ####        #
#            #                            #  #        #
#                                         #  #        #
#                                         #  #        #
#                                         #  #        #
#            #####################        #  #        #
#            #                   #        #  #        #
#                                #        ####        #
#                                #                    #
#                                #                    #
#            #                   #                    #
##############                   #################   ##
#                                                     #
#                                                     #
#                                                     #
#                #####################      #         #
#                #                   #      #         #
#                #                   #      #         #
##############   #                   #      #         #
#            #   #                   #      #         #
#            #   #                   #      #         #
#                #                   #      #         #
#                #                   #      #         #
#                #                          #         #
#            #   #                          #         #
#            #   #                          #         #
#############################################         #
#                                                     #
#                                                     #
#                                                     #
#               ####################                  #
#               #                  #                  #
#               #                  #                  #
#                                               #######
#                                               #
#                                               #
#               #                  #            #
#               ####################            #
#                                               #
#                                               #
#                                               #
#################################################